02 02 02 02 02 02 02 02 02 02 02 02 02 02 02 02 02 02 02 02 02 02 02 02 02 02 02 02 02 02 02 02 02 02 02 02 02 02 02 02 02 02 02 02 02 02 02 02 02 02
02 02 02 02 02 02 02 02 02 02 02 02 02 02 02 02 02 02 02 02 02 02 02 02 02 02 02 02 02 02 02 02 02 02 02 02 02 02 02 02 02 02 02 02 02 02 02 02 02 02
02 02 02 02 02 02 02 02 02 02 02 02 02 02 02 02 02 02 02 02 02 02 02 02 02 02 02 02 02 02 02 02 02 02 02 02 02 02 02 02 02 02 02 02 02 02 02 02 02 02
02 02 02 02 02 02 02 02 02 02 02 02 02 02 02 02 02 02 02 02 02 02 02 02 02 02 02 02 02 02 02 02 02 02 02 02 02 02 02 02 02 02 02 02 02 02 02 02 02 02
02 02 02 02 02 02 02 02 02 02 02 02 02 02 02 02 02 02 02 02 02 02 02 02 02 02 02 02 02 02 02 02 02 02 02 02 02 02 02 02 02 02 02 02 02 02 02 02 02 02
02 02 02 02 02 02 02 02 02 02 02 02 02 02 02 02 02 02 02 02 02 02 02 02 02 02 02 02 02 02 02 02 02 02 02 02 02 02 02 02 02 02 02 02 02 02 02 02 02 02
02 02 02 02 02 02 02 02 02 02 02 02 02 02 02 02 02 02 02 02 02 02 02 02 02 02 02 02 02 02 02 02 02 02 02 02 02 02 02 02 02 02 02 02 02 02 02 02 02 02
02 02 02 02 02 02 02 02 02 02 02 02 02 02 02 02 02 02 02 02 02 02 02 02 02 02 02 02 02 02 02 02 02 02 02 02 02 02 02 02 02 02 02 02 02 02 02 02 02 02
02 02 02 02 02 02 02 02 02 02 02 02 02 02 02 02 02 02 02 02 02 02 02 02 02 02 02 02 02 02 02 02 02 02 02 02 02 02 02 02 02 02 02 02 02 02 02 02 02 02
02 02 02 02 02 02 02 02 02 02 02 02 02 02 02 02 02 02 02 02 02 02 02 02 02 02 02 02 02 02 02 02 02 02 02 02 02 02 02 02 02 02 02 02 02 02 02 02 02 02
02 02 02 02 02 02 02 02 02 02 02 02 02 02 02 02 02 02 02 02 02 02 02 02 02 02 02 02 02 02 02 02 02 02 02 02 02 02 02 02 02 02 02 02 02 02 02 02 02 02
02 02 02 02 02 02 02 02 02 02 02 02 02 02 02 02 02 02 02 02 02 02 02 02 40 39 39 39 39 39 39 02 02 02 02 02 02 02 02 02 02 02 02 02 02 02 02 02 02 02
02 02 02 02 02 02 02 02 02 02 02 02 02 02 02 02 02 02 02 64 65 66 67 02 40 39 39 39 39 39 39 02 02 02 02 02 02 02 02 02 02 02 02 02 02 02 02 02 02 02
64 65 66 67 02 02 02 02 02 02 02 02 02 02 02 80 81 02 02 68 69 70 71 02 40 39 39 39 39 39 39 02 02 02 02 02 02 02 02 02 02 02 02 02 02 02 02 02 02 02
68 69 70 71 02 02 02 02 02 02 02 02 02 02 02 82 83 02 02 72 73 74 75 34 46 39 39 39 39 39 39 02 02 02 02 02 02 02 02 02 02 02 02 02 02 02 02 02 02 02
72 73 74 75 02 02 02 02 02 02 02 02 02 02 02 02 02 02 00 76 77 78 79 40 39 39 39 39 39 39 02 02 02 02 02 02 02 02 02 02 02 02 02 02 02 02 02 02 02 02
76 77 78 79 02 02 02 84 91 91 91 91 91 91 91 91 91 91 91 91 91 91 85 40 39 39 39 39 39 39 02 02 02 02 02 02 02 02 02 02 02 02 02 02 02 02 02 02 02 02
02 02 02 02 02 02 02 02 02 02 02 02 02 02 01 02 02 02 80 81 80 81 87 40 39 39 39 39 39 39 02 02 02 02 02 02 02 02 02 02 02 02 02 02 02 02 02 02 02 02
02 02 02 02 02 02 02 02 02 02 02 02 02 02 02 02 02 02 82 83 82 83 87 40 39 39 39 39 39 39 02 02 02 02 02 02 02 02 02 02 02 02 02 02 02 02 02 02 02 02
02 02 02 02 02 02 02 02 02 202 123 124 125 126 127 128 129 130 131 02 02 02 87 40 39 39 39 39 39 39 02 02 02 02 02 02 02 02 02 02 02 02 02 02 02 02 02 02 02 02
02 02 02 02 02 02 02 86 02 132 133 134 135 136 137 138 139 140 141 02 01 02 87 40 39 39 39 39 39 39 02 02 02 02 02 02 02 02 02 02 02 02 02 02 02 02 02 02 02 02
02 02 02 02 02 02 02 86 02 142 143 144 145 146 147 148 149 150 151 01 02 02 87 37 44 39 39 39 39 39 39 02 02 02 02 02 02 02 02 02 02 02 02 02 02 02 02 02 02 02
02 02 02 02 02 02 02 86 02 152 153 154 155 156 157 158 159 160 161 02 01 02 87 00 37 44 39 39 39 39 39 39 02 02 02 02 02 02 02 02 02 02 02 02 02 02 02 02 02 02
02 02 02 02 02 02 02 86 02 162 163 164 165 166 167 168 169 170 171 02 02 02 87 03 04 40 39 39 39 39 39 39 02 02 02 02 02 02 02 02 02 02 02 02 02 02 02 02 02 02
02 02 02 02 02 02 02 86 02 172 173 174 175 176 177 178 179 180 181 01 02 02 87 05 06 40 39 39 39 39 39 39 02 02 02 02 02 02 02 02 02 02 02 02 02 02 02 02 02 02
02 80 81 80 81 02 02 86 02 182 183 184 185 186 187 188 189 190 191 02 02 02 87 02 02 40 39 39 39 39 39 39 02 02 02 02 02 02 02 02 02 02 02 02 02 02 02 02 02 02
02 82 83 82 83 80 81 86 02 192 193 194 195 196 197 198 199 200 201 02 80 81 87 02 02 40 39 39 39 39 39 39 02 02 02 02 02 02 02 02 02 02 02 02 02 02 02 02 02 02
25 26 26 26 27 82 83 86 02 01 02 02 02 02 01 00 02 02 01 02 82 83 87 02 02 40 39 39 39 39 39 39 02 02 02 02 02 02 02 02 02 02 02 02 02 02 02 02 02 02
28 02 02 01 30 02 02 88 91 91 91 91 91 91 91 91 91 91 91 91 91 91 89 02 00 40 39 39 39 39 39 39 02 02 02 02 02 02 02 02 02 02 02 02 02 02 02 02 02 02
28 00 02 02 30 00 34 42 42 42 41 02 02 02 02 80 81 80 81 80 81 80 81 80 81 40 39 39 39 39 39 39 02 02 02 02 02 02 02 02 02 02 02 02 02 02 02 02 02 02
31 32 32 32 33 34 46 39 39 39 38 02 02 02 02 82 83 82 83 82 83 82 83 82 83 40 39 39 39 39 39 39 02 02 02 02 02 02 02 02 02 02 02 02 02 02 02 02 02 02
42 42 42 42 42 46 39 39 39 39 45 41 02 02 02 02 02 02 02 02 02 02 02 34 42 46 39 39 39 39 39 39 02 02 02 02 02 02 02 02 02 02 02 02 02 02 02 02 02 02
39 39 39 39 39 39 39 39 39 39 39 45 42 42 42 42 42 42 42 42 42 42 42 46 39 39 39 39 39 39 02 02 02 02 02 02 02 02 02 02 02 02 02 02 02 02 02 02 02 02
39 39 39 39 39 39 39 39 39 39 39 39 39 39 39 39 39 39 39 39 39 39 39 39 39 39 39 39 02 02 02 02 02 02 02 02 02 02 02 02 02 02 02 02 02 02 02 02 02 02
02 02 02 02 02 02 02 02 02 02 02 02 02 02 02 02 02 02 02 02 02 02 02 02 02 02 02 02 02 02 02 02 02 02 02 02 02 02 02 02 02 02 02 02 02 02 02 02 02 02
02 02 02 02 02 02 02 02 02 02 02 02 02 02 02 02 02 02 02 02 02 02 02 02 02 02 02 02 02 02 02 02 02 02 02 02 02 02 02 02 02 02 02 02 02 02 02 02 02 02
02 02 02 02 02 02 02 02 02 02 02 02 02 02 02 02 02 02 02 02 02 02 02 02 02 02 02 02 02 02 02 02 02 02 02 02 02 02 02 02 02 02 02 02 02 02 02 02 02 02
02 02 02 02 02 02 02 02 02 02 02 02 02 02 02 02 02 02 02 02 02 02 02 02 02 02 02 02 02 02 02 02 02 02 02 02 02 02 02 02 02 02 02 02 02 02 02 02 02 02
02 02 02 02 02 02 02 02 02 02 02 02 02 02 02 02 02 02 02 02 02 02 02 02 02 02 02 02 02 02 02 02 02 02 02 02 02 02 02 02 02 02 02 02 02 02 02 02 02 02
02 02 02 02 02 02 02 02 02 02 02 02 02 02 02 02 02 02 02 02 02 02 02 02 02 02 02 02 02 02 02 02 02 02 02 02 02 02 02 02 02 02 02 02 02 02 02 02 02 02
02 02 02 02 02 02 02 02 02 02 02 02 02 02 02 02 02 02 02 02 02 02 02 02 02 02 02 02 02 02 02 02 02 02 02 02 02 02 02 02 02 02 02 02 02 02 02 02 02 02
02 02 02 02 02 02 02 02 02 02 02 02 02 02 02 02 02 02 02 02 02 02 02 02 02 02 02 02 02 02 02 02 02 02 02 02 02 02 02 02 02 02 02 02 02 02 02 02 02 02
02 02 02 02 02 02 02 02 02 02 02 02 02 02 02 02 02 02 02 02 02 02 02 02 02 02 02 02 02 02 02 02 02 02 02 02 02 02 02 02 02 02 02 02 02 02 02 02 02 02
02 02 02 02 02 02 02 02 02 02 02 02 02 02 02 02 02 02 02 02 02 02 02 02 02 02 02 02 02 02 02 02 02 02 02 02 02 02 02 02 02 02 02 02 02 02 02 02 02 02
02 02 02 02 02 02 02 02 02 02 02 02 02 02 02 02 02 02 02 02 02 02 02 02 02 02 02 02 02 02 02 02 02 02 02 02 02 02 02 02 02 02 02 02 02 02 02 02 02 02
02 02 02 02 02 02 02 02 02 02 02 02 02 02 02 02 02 02 02 02 02 02 02 02 02 02 02 02 02 02 02 02 02 02 02 02 02 02 02 02 02 02 02 02 02 02 02 02 02 02
02 02 02 02 02 02 02 02 02 02 02 02 02 02 02 02 02 02 02 02 02 02 02 02 02 02 02 02 02 02 02 02 02 02 02 02 02 02 02 02 02 02 02 02 02 02 02 02 02 02
02 02 02 02 02 02 02 02 02 02 02 02 02 02 02 02 02 02 02 02 02 02 02 02 02 02 02 02 02 02 02 02 02 02 02 02 02 02 02 02 02 02 02 02 02 02 02 02 02 02
02 02 02 02 02 02 02 02 02 02 02 02 02 02 02 02 02 02 02 02 02 02 02 02 02 02 02 02 02 02 02 02 02 02 02 02 02 02 02 02 02 02 02 02 02 02 02 02 02 02
02 02 02 02 02 02 02 02 02 02 02 02 02 02 02 02 02 02 02 02 02 02 02 02 02 02 02 02 02 02 02 02 02 02 02 02 02 02 02 02 02 02 02 02 02 02 02 02 02 02
