39 39 39 39 39 39 39 39 39 39 39 39 39 39 39 39 39 39 39 39 39 39 39 39 39 39 39 39 39 39 39 39 39 39 39 39 39 39 39 39 39 39 39 39 39 39 39 39 39 39
39 39 39 39 39 39 39 39 39 39 39 39 39 39 39 39 39 39 39 39 39 39 39 39 39 39 39 39 39 39 39 39 39 39 39 39 39 39 39 39 39 39 39 39 39 39 39 39 39 39
39 39 39 39 39 39 39 39 39 39 39 39 39 39 39 39 39 39 39 39 39 39 39 39 39 39 39 39 39 39 39 39 39 39 39 39 39 39 39 39 39 39 39 39 39 39 39 39 39 39
39 39 39 39 39 39 39 39 39 39 39 39 39 39 39 39 39 39 39 39 39 39 39 39 39 39 39 39 39 39 39 39 39 39 39 39 39 39 39 39 39 39 39 39 39 39 39 39 39 39
39 39 39 39 39 39 39 39 39 39 39 39 39 39 39 39 39 39 39 39 39 39 39 39 39 39 39 39 39 39 39 39 39 39 39 39 39 39 39 39 39 39 39 39 39 39 39 39 39 39
39 39 39 39 39 39 39 39 39 39 39 39 39 39 39 39 39 39 39 39 39 39 39 39 39 39 39 39 39 39 39 39 39 39 39 39 39 39 39 39 39 39 39 39 39 39 39 39 39 39
39 39 39 39 39 39 39 39 39 43 36 36 36 36 36 36 44 39 39 43 36 36 36 36 36 36 36 44 39 39 39 39 43 36 36 36 36 36 36 36 36 36 44 39 39 39 39 39 39 39
39 39 39 39 39 39 39 39 43 35 02 02 02 02 02 02 37 36 36 35 02 02 02 02 02 02 02 37 36 36 36 36 35 02 02 02 02 02 02 02 02 02 40 39 39 39 39 39 39 39 
39 39 39 39 39 39 39 39 38 02 93 94 95 96 97 98 02 63 63 63 63 63 63 63 63 63 63 63 63 63 63 63 63 63 63 63 63 63 64 65 66 67 40 39 39 39 39 39 39 39
39 39 39 39 39 39 39 39 38 02 99 100 101 102 103 104 02 63 02 02 02 02 02 02 02 02 02 02 02 02 02 02 02 02 02 63 02 63 68 69 70 71 40 39 39 39 39 39 39 39 
39 39 39 39 39 39 39 39 38 02 105 106 107 108 109 110 02 63 02 63 63 63 63 63 63 63 63 63 63 63 63 63 63 63 63 63 02 63 72 73 74 75 40 39 39 39 39 39 39 39 
39 39 39 39 39 39 39 39 38 02 111 112 113 114 115 116 02 63 02 63 02 02 02 02 02 02 02 02 02 02 02 02 02 02 02 63 02 63 76 77 78 79 40 39 39 39 39 39 39 39 
39 39 39 39 39 39 39 39 38 02 117 118 119 120 121 122 02 63 02 63 63 63 63 63 63 63 63 63 63 63 63 63 63 63 63 63 02 63 02 02 02 02 40 39 39 39 39 39 39 39 
39 39 39 39 39 39 39 39 38 02 02 02 02 02 02 02 02 02 02 02 02 02 02 02 02 02 02 02 02 02 02 02 02 02 02 63 02 63 02 02 34 42 46 39 39 39 39 39 39 39 
39 39 39 39 39 39 39 39 45 41 63 63 63 63 63 63 02 63 63 63 63 63 63 63 63 63 63 63 63 63 63 63 63 63 63 63 02 63 02 02 40 39 39 39 39 39 39 39 39 39 
39 39 39 39 39 39 39 39 39 38 63 02 63 02 02 02 02 02 02 02 02 02 02 02 02 02 02 02 02 02 02 02 02 02 02 02 02 63 03 04 40 39 39 39 39 39 39 39 39 39 
39 39 39 39 39 39 39 39 39 38 63 02 63 63 63 63 63 63 63 63 63 63 63 63 63 63 63 63 63 63 63 63 63 63 63 63 02 63 05 06 40 39 39 39 39 39 39 39 39 39 
39 39 39 39 39 39 39 43 36 35 63 02 63 02 02 02 02 02 02 02 02 63 02 02 02 02 02 02 02 02 02 02 02 02 02 63 02 63 02 00 40 39 39 39 39 39 39 39 39 39 
39 39 39 39 39 39 39 38 80 81 63 02 63 02 63 63 63 63 63 63 02 63 02 63 63 63 63 63 63 63 63 63 63 63 02 63 02 63 01 02 40 39 39 39 39 39 39 39 39 39 
39 39 39 39 39 39 39 38 82 83 63 02 63 02 63 02 02 02 63 02 02 63 02 02 02 02 02 02 02 02 02 02 02 63 02 63 02 63 80 81 40 39 39 39 39 39 39 39 39 39 
39 39 39 39 39 39 39 38 80 81 63 02 63 02 63 02 63 02 02 02 02 63 63 63 63 63 63 63 02 63 63 63 02 63 02 63 02 63 82 83 40 39 39 39 39 39 39 39 39 39 
39 39 39 39 39 39 39 38 82 83 63 02 63 02 63 02 63 63 63 63 63 63 02 02 02 02 02 02 02 02 02 02 02 63 02 63 02 63 02 34 46 39 39 39 39 39 39 39 39 39 
39 39 39 39 39 39 39 38 02 00 63 02 63 02 63 02 02 02 02 02 02 02 02 63 63 63 63 02 63 63 63 63 63 63 02 02 02 63 02 40 39 39 39 39 39 39 39 39 39 39 
39 39 39 39 39 39 39 45 41 63 63 02 63 02 63 63 63 63 63 63 63 63 63 63 63 63 63 63 63 63 63 63 63 63 02 63 02 63 02 40 39 39 39 39 39 39 39 39 39 39 
39 39 39 39 39 39 39 39 38 63 02 02 02 02 63 02 02 02 02 02 02 02 02 02 02 02 02 02 02 02 02 02 02 02 02 63 02 63 02 40 39 39 39 39 39 39 39 39 39 39 
39 39 39 39 39 39 39 39 38 63 02 63 02 63 63 63 63 63 63 63 63 63 63 63 63 63 63 63 63 63 63 63 63 63 02 63 02 63 02 40 39 39 39 39 39 39 39 39 39 39 
39 39 39 39 39 39 39 43 35 63 02 63 02 02 02 02 02 02 02 02 02 02 02 02 02 02 02 02 02 02 02 02 02 63 02 63 02 63 02 40 39 39 39 39 39 39 39 39 39 39 
39 39 39 39 39 39 39 38 01 63 02 63 02 63 63 63 63 63 63 63 63 63 63 63 63 63 63 63 63 63 02 63 02 63 02 63 02 63 02 40 39 39 39 39 39 39 39 39 39 39 
39 39 39 39 39 39 39 38 02 63 02 63 02 63 02 02 02 02 02 02 02 02 02 02 02 02 02 02 02 63 02 63 02 02 02 63 02 63 02 40 39 39 39 39 39 39 39 39 39 39 
39 39 39 39 39 39 39 38 02 63 02 63 02 63 63 63 63 63 63 63 63 63 63 63 63 63 63 63 02 63 02 63 02 63 02 63 02 63 02 40 39 39 39 39 39 39 39 39 39 39 
39 39 39 39 39 39 39 38 02 63 02 63 02 63 02 02 63 02 63 63 63 63 63 63 02 02 02 02 02 63 02 63 02 63 02 63 02 63 34 46 39 39 39 39 39 39 39 39 39 39 
39 39 39 39 39 39 39 45 41 63 02 63 02 63 02 02 02 02 02 02 02 02 02 02 02 02 02 02 02 63 02 63 02 63 02 63 02 63 40 39 39 39 39 39 39 39 39 39 39 39 
39 39 39 39 39 39 39 39 38 63 02 63 63 63 63 63 02 63 63 63 63 63 63 63 63 63 63 63 63 63 02 63 63 63 02 63 02 63 40 39 39 39 39 39 39 39 39 39 39 39 
39 39 39 39 39 39 39 39 38 63 02 63 02 02 02 02 02 02 02 02 02 02 02 02 02 02 02 02 02 02 02 02 02 02 02 63 02 63 40 39 39 39 39 39 39 39 39 39 39 39 
39 39 39 39 39 39 39 39 38 63 02 63 63 63 63 63 63 63 63 63 63 63 63 63 63 63 63 63 63 63 63 63 63 02 63 63 02 63 40 39 39 39 39 39 39 39 39 39 39 39 
39 39 39 39 39 39 39 39 38 63 02 02 02 02 02 02 02 02 02 02 02 02 02 02 02 02 02 02 02 02 02 02 02 02 02 02 02 63 37 44 39 39 39 39 39 39 39 39 39 39 
39 39 39 39 39 39 39 43 35 63 63 63 63 63 63 02 63 63 63 63 63 63 63 63 63 63 63 63 63 63 63 63 63 63 63 63 02 63 02 37 44 39 39 39 39 39 39 39 39 39 
39 39 39 39 39 39 39 38 02 02 02 02 02 02 63 02 02 02 02 02 02 02 02 02 02 02 02 02 02 02 02 07 08 08 08 08 08 08 09 02 40 39 39 39 39 39 39 39 39 39 
39 39 39 39 39 39 39 38 02 02 02 02 02 02 63 63 63 63 63 63 63 63 63 02 63 63 63 63 63 63 63 10 12 12 12 12 12 12 11 02 40 39 39 39 39 39 39 39 39 39 
39 39 39 39 39 39 39 38 02 02 02 02 02 02 02 02 02 02 02 02 02 02 02 02 02 02 02 02 02 02 02 10 12 12 12 12 12 12 11 02 40 39 39 39 39 39 39 39 39 39 
39 39 39 39 39 39 39 38 02 02 02 02 02 02 63 63 63 63 63 63 63 63 63 63 63 63 63 63 63 63 63 10 12 12 12 12 12 12 11 02 40 39 39 39 39 39 39 39 39 39 
39 39 39 39 39 39 39 38 02 02 02 02 02 02 02 34 42 42 41 02 02 02 02 02 02 02 02 34 42 42 41 10 12 12 12 12 12 12 11 02 40 39 39 39 39 39 39 39 39 39 
39 39 39 39 39 39 39 38 02 02 02 02 02 02 34 46 39 39 45 41 02 02 02 02 02 02 34 46 39 39 38 13 14 14 14 14 14 14 15 02 40 39 39 39 39 39 39 39 39 39 
39 39 39 39 39 39 39 45 42 42 42 42 42 42 46 39 39 39 39 45 42 42 42 42 42 42 46 39 39 39 45 41 02 02 02 02 02 02 34 42 46 39 39 39 39 39 39 39 39 39 
39 39 39 39 39 39 39 39 39 39 39 39 39 39 39 39 39 39 39 39 39 39 39 39 39 39 39 39 39 39 39 45 42 42 42 42 42 42 46 39 39 39 39 39 39 39 39 39 39 39 
39 39 39 39 39 39 39 39 39 39 39 39 39 39 39 39 39 39 39 39 39 39 39 39 39 39 39 39 39 39 39 39 39 39 39 39 39 39 39 39 39 39 39 39 39 39 39 39 39 39 
39 39 39 39 39 39 39 39 39 39 39 39 39 39 39 39 39 39 39 39 39 39 39 39 39 39 39 39 39 39 39 39 39 39 39 39 39 39 39 39 39 39 39 39 39 39 39 39 39 39 
39 39 39 39 39 39 39 39 39 39 39 39 39 39 39 39 39 39 39 39 39 39 39 39 39 39 39 39 39 39 39 39 39 39 39 39 39 39 39 39 39 39 39 39 39 39 39 39 39 39 
39 39 39 39 39 39 39 39 39 39 39 39 39 39 39 39 39 39 39 39 39 39 39 39 39 39 39 39 39 39 39 39 39 39 39 39 39 39 39 39 39 39 39 39 39 39 39 39 39 39 
39 39 39 39 39 39 39 39 39 39 39 39 39 39 39 39 39 39 39 39 39 39 39 39 39 39 39 39 39 39 39 39 39 39 39 39 39 39 39 39 39 39 39 39 39 39 39 39 39 39 