46 46 46 46 46 46 46 46 46 46 46 46 46 46 46 46 46 46 46 46 46 46 46 46 46 46 46 46 46 46 46 46 46 46 46 46 46 46 46 46 46 46 46 46 46 46 46 46 46 46 
46 46 46 46 46 46 46 46 46 46 46 46 46 46 46 46 46 46 46 46 46 46 46 46 46 46 46 46 46 46 46 46 46 46 46 46 46 46 46 46 46 46 46 46 46 46 46 46 46 46 
46 46 46 46 46 46 46 46 46 46 46 46 46 46 46 46 46 46 46 46 46 46 46 46 46 46 46 46 46 46 46 46 46 46 46 46 46 46 46 46 46 46 46 46 46 46 46 46 46 46 
46 46 46 46 46 46 46 46 46 46 46 46 46 46 46 46 46 46 46 46 46 46 46 46 46 46 46 46 46 46 46 46 46 46 46 46 46 46 46 46 46 46 46 46 46 46 46 46 46 46  
46 46 46 46 46 46 46 46 46 46 46 46 46 46 46 46 46 46 46 46 46 46 46 46 46 46 46 46 46 46 46 46 46 46 46 46 46 46 46 46 46 46 46 46 46 46 46 46 46 46 
46 46 46 46 46 46 46 46 46 46 46 46 46 46 46 46 46 46 46 46 46 46 46 46 46 46 46 46 46 46 46 46 46 46 46 46 46 46 46 46 46 46 46 46 46 46 46 46 46 46  
46 46 46 46 46 46 22 20 20 20 20 20 20 20 23 46 46 46 22 20 20 20 20 20 20 20 20 23 46 46 46 22 20 20 20 20 20 20 20 20 20 20 23 46 46 46 46 46 46 46 
46 46 46 46 46 46 18 20 40 40 40 40 40 20 41 20 20 20 40 20 10 10 11 10 10 10 10 41 20 20 20 40 20 10 35 33 33 33 33 33 33 36 17 46 46 46 46 46 46 46 
46 46 46 46 46 46 18 20 40 39 39 39 40 20 20 20 20 20 20 20 10 46 46 46 46 46 10 20 20 20 20 20 20 20 40 40 40 40 40 40 40 41 17 46 46 46 46 46 46 46
46 46 46 46 46 46 18 20 40 39 39 39 40 20 20 20 20 20 20 20 10 46 46 46 46 46 10 20 20 20 20 20 20 20 40 40 40 40 40 40 40 41 17 46 46 46 46 46 46 46 
46 46 46 46 46 46 18 20 40 39 39 39 40 20 20 20 20 20 20 20 10 46 46 46 46 46 11 20 20 20 20 20 20 20 40 40 40 40 40 40 40 41 17 46 46 46 46 46 46 46 
46 46 46 46 46 46 18 20 40 39 39 39 40 20 20 20 20 20 20 20 10 46 46 46 46 46 10 20 20 20 20 20 20 20 40 40 40 40 40 40 40 41 17 46 46 46 46 46 46 46 
46 46 46 46 46 46 18 20 40 40 39 40 40 20 20 20 20 20 20 20 11 46 46 46 46 46 10 20 20 20 20 20 20 20 37 28 28 29 40 27 28 38 17 46 46 46 46 46 46 46 
46 46 46 46 46 46 18 20 20 20 10 20 20 20 20 20 20 20 20 20 20 20 40 42 41 20 20 20 20 20 20 20 20 20 20 20 20 40 40 41 14 15 25 46 46 46 46 46 46 46 
46 46 46 46 46 46 18 20 20 20 10 20 20 20 20 20 20 20 20 20 20 20 40 42 41 20 20 20 20 20 20 20 20 20 20 20 20 40 40 41 17 46 46 46 46 46 46 46 46 46 
46 46 46 46 46 46 24 15 16 20 10 20 20 20 20 20 20 20 20 20 20 20 40 42 41 20 20 20 20 20 20 20 20 20 20 20 20 40 40 41 17 46 46 46 46 46 46 46 46 46 
46 46 46 46 46 46 46 46 18 20 10 20 20 20 20 20 20 20 20 20 20 20 40 42 41 10 10 10 20 20 20 20 20 20 20 20 20 40 40 41 17 46 46 46 46 46 46 46 46 46 
46 46 46 46 46 46 46 22 40 20 10 20 20 20 20 20 20 20 20 20 20 20 40 42 41 20 20 20 20 20 20 20 20 20 20 35 33 34 40 41 17 46 46 46 46 46 46 46 46 46 
46 46 46 46 46 46 46 18 10 10 10 20 20 20 20 20 20 20 20 20 20 20 40 42 41 20 20 20 20 20 20 20 20 20 20 40 40 40 40 41 17 46 46 46 46 46 46 46 46 46 
46 46 46 46 46 46 46 18 10 20 20 20 20 20 20 20 20 20 20 20 20 10 40 42 41 10 20 20 20 20 20 20 20 20 20 40 40 27 28 38 17 46 46 46 46 46 46 46 46 46 
46 46 46 46 46 46 46 18 10 20 20 20 10 35 33 38 38 38 38 38 38 38 38 42 32 38 38 38 38 38 38 38 38 38 38 34 40 41 10 20 17 46 46 46 46 46 46 46 46 46 
46 46 46 46 46 46 46 18 10 20 20 20 11 42 42 42 42 42 42 42 42 42 42 42 42 42 42 42 42 42 42 42 42 42 42 42 42 41 10 14 25 46 46 46 46 46 46 46 46 46 
46 46 46 46 46 46 46 18 10 10 20 20 10 37 44 44 44 44 44 44 44 44 29 40 27 44 44 44 44 44 44 44 44 44 44 29 40 41 10 17 46 46 46 46 46 46 46 46 46 46 
46 46 46 46 46 46 46 24 16 10 20 20 10 20 20 20 20 20 20 20 20 10 40 42 41 10 20 20 20 20 20 20 20 20 20 40 40 41 10 17 46 46 46 46 46 46 46 46 46 46 
46 46 46 46 46 46 46 46 18 10 20 20 10 20 20 20 20 20 20 20 20 20 40 42 41 20 20 20 20 20 20 20 20 20 20 40 40 41 11 17 46 46 46 46 46 46 46 46 46 46 
46 46 46 46 46 46 46 22 40 10 20 20 10 10 10 20 20 20 20 20 20 20 40 42 41 20 20 20 20 20 20 20 20 20 20 40 40 41 10 17 46 46 46 46 46 46 46 46 46 46 
46 46 46 46 46 46 46 18 10 10 20 20 20 20 10 20 20 20 20 20 20 20 40 42 41 20 20 20 20 20 20 20 20 20 20 40 40 41 10 17 46 46 46 46 46 46 46 46 46 46 
46 46 46 46 46 46 46 18 10 20 20 20 20 20 10 20 20 20 20 20 20 20 40 42 41 20 20 10 20 20 20 20 20 20 20 40 40 41 10 17 46 46 46 46 46 46 46 46 46 46 
46 46 46 46 46 46 46 18 10 20 20 20 20 20 10 20 20 20 20 20 20 20 40 42 41 20 20 20 20 20 10 20 20 20 20 40 40 41 10 17 46 46 46 46 46 46 46 46 46 46 
46 46 46 46 46 46 46 18 10 10 10 10 10 10 10 20 20 20 20 20 20 20 40 42 41 20 20 20 20 20 10 20 20 20 20 37 28 38 10 17 46 46 46 46 46 46 46 46 46 46 
46 46 46 46 46 46 46 18 10 10 11 10 10 10 10 20 20 20 20 20 20 20 40 42 41 20 20 20 20 20 20 20 20 20 20 20 10 20 14 25 46 46 46 46 46 46 46 46 46 46 
46 46 46 46 46 46 46 24 16 10 10 10 10 10 10 20 20 20 20 20 20 20 40 42 41 20 20 20 20 20 20 20 20 20 20 10 10 10 17 46 46 46 46 46 46 46 46 46 46 46 
46 46 46 46 46 46 46 46 18 10 10 10 10 11 10 20 20 20 20 20 20 20 40 42 41 20 20 20 20 20 20 20 20 20 20 10 10 10 17 46 46 46 46 46 46 46 46 46 46 46 
46 46 46 46 46 46 46 46 18 11 10 10 10 10 10 20 20 20 20 20 20 20 40 42 41 20 20 20 20 20 20 20 20 20 20 10 10 11 17 46 46 46 46 46 46 46 46 46 46 46 
46 46 46 46 46 46 46 46 18 10 10 10 10 10 10 20 20 20 20 20 20 20 40 42 41 20 20 20 20 20 20 20 20 20 20 10 10 10 17 46 46 46 46 46 46 46 46 46 46 46 
46 46 46 46 46 46 46 22 40 20 20 20 20 20 20 20 20 20 20 20 20 20 37 28 38 20 20 20 20 20 20 20 20 20 20 11 10 10 41 23 46 46 46 46 46 46 46 46 46 46 
46 46 46 46 46 46 46 18 20 20 20 20 20 20 20 20 20 20 20 10 10 10 10 10 10 10 10 20 20 20 20 20 20 20 10 10 10 10 10 41 23 46 46 46 46 46 46 46 46 46 
46 46 46 46 46 46 46 18 20 20 20 20 20 20 20 20 20 20 10 10 10 10 10 10 10 10 10 10 20 20 10 20 20 10 10 10 10 10 10 10 17 46 46 46 46 46 46 46 46 46 
46 46 46 46 46 46 46 18 10 20 20 20 20 20 20 20 20 20 10 11 10 10 10 10 10 11 10 10 20 20 20 20 10 10 10 10 10 11 10 10 17 46 46 46 46 46 46 46 46 46 
46 46 46 46 46 46 46 18 10 20 20 20 20 10 20 20 20 20 10 10 11 10 10 10 10 10 10 10 10 20 20 20 10 10 10 10 10 20 10 10 17 46 46 46 46 46 46 46 46 46 
46 46 46 46 46 46 46 18 10 20 20 20 20 20 20 20 20 20 10 10 10 10 10 10 10 10 10 10 10 10 10 10 10 10 20 10 10 10 10 10 17 46 46 46 46 46 46 46 46 46 
46 46 46 46 46 46 46 18 10 20 20 20 20 10 20 14 15 15 16 10 10 10 10 10 11 10 10 14 15 15 16 10 10 10 10 10 10 10 11 10 17 46 46 46 46 46 46 46 46 46 
46 46 46 46 46 46 46 18 20 20 20 20 20 20 14 25 46 46 24 16 10 10 10 10 10 10 14 25 46 46 18 10 10 20 10 10 20 10 10 10 17 46 46 46 46 46 46 46 46 46 
46 46 46 46 46 46 46 24 15 15 15 15 15 15 25 46 46 46 46 24 15 15 15 15 15 15 25 46 46 46 24 16 10 11 10 10 10 10 14 15 25 46 46 46 46 46 46 46 46 46 
46 46 46 46 46 46 46 46 46 46 46 46 46 46 46 46 46 46 46 46 46 46 46 46 46 46 46 46 46 46 46 24 15 15 15 15 15 15 25 46 46 46 46 46 46 46 46 46 46 46 
46 46 46 46 46 46 46 46 46 46 46 46 46 46 46 46 46 46 46 46 46 46 46 46 46 46 46 46 46 46 46 46 46 46 46 46 46 46 46 46 46 46 46 46 46 46 46 46 46 46 
46 46 46 46 46 46 46 46 46 46 46 46 46 46 46 46 46 46 46 46 46 46 46 46 46 46 46 46 46 46 46 46 46 46 46 46 46 46 46 46 46 46 46 46 46 46 46 46 46 46 
46 46 46 46 46 46 46 46 46 46 46 46 46 46 46 46 46 46 46 46 46 46 46 46 46 46 46 46 46 46 46 46 46 46 46 46 46 46 46 46 46 46 46 46 46 46 46 46 46 46 
46 46 46 46 46 46 46 46 46 46 46 46 46 46 46 46 46 46 46 46 46 46 46 46 46 46 46 46 46 46 46 46 46 46 46 46 46 46 46 46 46 46 46 46 46 46 46 46 46 46 
46 46 46 46 46 46 46 46 46 46 46 46 46 46 46 46 46 46 46 46 46 46 46 46 46 46 46 46 46 46 46 46 46 46 46 46 46 46 46 46 46 46 46 46 46 46 46 46 46 46 