41 41 41 41 41 41 41 41 41 41 41 41 41 41 41 41 41 41 41 41 41 41 41 41 41 41 41 41 41 41 41 41 41 41 41 41 41 41 41 41 41 41 41 41 41 41 41 41 41 41 
41 41 41 41 41 41 41 41 41 41 41 41 41 41 41 41 41 41 41 41 41 41 41 41 41 41 41 41 41 41 41 41 41 41 41 41 41 41 41 41 41 41 41 41 41 41 41 41 41 41 
41 41 41 41 41 41 41 41 41 41 41 41 41 41 41 41 41 41 41 41 0 12 12 12 12 12 0 41 41 41 41 41 41 41 41 41 41 41 41 41 41 41 41 41 41 41 41 41 41 41 
41 41 41 41 41 41 41 41 41 41 41 41 41 41 41 41 41 41 41 41 12 12 12 12 12 12 12 41 41 41 41 41 41 41 41 41 41 41 41 41 41 41 41 41 41 41 41 41 41 41 
41 41 41 41 41 41 41 41 41 41 41 41 41 41 41 41 41 41 41 41 12 12 12 12 12 12 12 41 41 41 41 41 41 41 41 41 41 41 41 41 41 41 41 41 41 41 41 41 41 41 
41 41 41 41 41 41 41 41 41 41 41 41 41 41 41 41 41 41 41 41 12 12 12 12 12 12 12 41 41 41 41 41 41 41 41 41 41 41 41 41 41 41 41 41 41 41 41 41 41 41 
41 41 41 41 41 41 41 41 1 1 1 1 1 41 41 41 41 41 41 41 41 12 12 12 12 12 41 41 41 41 41 41 41 41 41 41 41 41 41 41 41 41 41 41 41 41 41 41 41 41 
41 41 41 41 41 41 41 41 1 3 3 3 1 41 41 41 41 41 41 41 0 0 0 0 0 0 0 41 41 41 41 41 41 0 26 26 26 26 26 26 26 41 41 41 41 41 41 41 41 41 
41 41 41 41 41 41 41 41 1 3 3 3 1 41 41 41 41 41 41 41 41 0 0 0 0 0 41 41 41 41 41 41 41 41 26 26 26 26 26 26 26 26 41 41 41 41 41 41 41 41 
41 41 41 41 41 41 41 41 1 3 3 3 1 41 41 41 41 41 41 41 41 41 0 0 0 41 41 41 41 41 41 41 41 41 26 26 26 26 26 26 26 26 41 41 41 41 41 41 41 41 
41 41 41 41 41 41 41 41 1 3 3 3 1 41 41 41 41 41 41 41 41 41 41 26 41 41 41 41 41 41 41 41 41 41 26 26 26 26 26 26 26 26 41 41 41 41 41 41 41 41 
41 41 41 41 41 41 41 41 1 1 0 1 1 41 41 41 41 41 41 41 41 41 41 26 41 41 41 41 41 41 41 41 41 41 26 26 26 26 26 26 26 26 41 41 41 41 41 41 41 41 
41 41 41 41 41 41 41 41 41 41 0 41 41 41 41 41 41 41 41 41 41 41 41 26 41 41 41 41 41 41 41 41 41 41 41 26 26 26 26 26 26 41 41 41 41 41 41 41 41 41 
41 41 41 41 41 41 41 41 41 41 0 41 41 41 41 41 41 41 41 41 41 41 41 26 41 41 41 41 41 41 41 41 41 41 41 41 41 41 26 41 41 41 41 41 41 41 41 41 41 41 
41 41 41 41 41 41 41 41 41 41 0 41 41 41 41 41 41 41 41 41 41 41 41 26 41 41 41 41 41 41 41 41 41 41 41 41 41 41 26 41 41 41 41 41 41 41 41 41 41 41 
41 41 41 41 41 41 41 41 41 41 0 41 41 41 41 41 41 41 41 41 41 41 41 26 41 41 41 41 41 41 41 41 41 41 41 41 41 41 26 41 41 41 41 41 41 41 41 41 41 41 
41 41 41 41 41 41 41 41 0 0 0 41 41 41 41 41 41 41 41 41 41 41 41 26 41 41 41 41 41 41 41 41 41 41 41 41 41 41 26 41 41 41 41 41 41 41 41 41 41 41 
41 41 41 41 41 41 41 41 0 41 41 41 41 41 41 41 41 41 41 41 41 41 41 26 41 41 41 41 41 41 41 41 41 41 41 41 41 41 26 41 41 41 41 41 41 41 41 41 41 41 
41 41 41 41 41 41 41 41 0 41 41 41 41 41 41 41 41 41 41 41 41 41 0 26 0 41 41 41 41 41 41 41 41 41 41 41 26 26 26 41 41 41 41 41 41 41 41 41 41 41 
41 41 41 41 41 41 41 41 0 41 41 41 41 41 41 41 41 41 41 41 41 0 0 26 0 0 41 41 41 41 41 41 41 41 41 41 26 41 41 41 41 41 41 41 41 41 41 41 41 41 
41 41 41 41 41 41 41 41 0 41 41 41 41 41 41 41 41 41 41 41 0 0 0 26 0 0 0 41 41 41 41 41 41 41 41 26 26 41 41 41 41 41 41 41 41 41 41 41 41 41 
41 41 41 41 41 41 41 41 0 41 41 41 26 26 26 26 26 26 26 26 26 26 26 26 26 26 26 26 26 26 26 26 26 26 26 26 26 41 41 41 41 41 41 41 41 41 41 41 41 41 
41 41 41 41 41 41 41 41 0 41 41 41 0 41 41 41 41 41 41 41 0 0 0 26 0 0 0 41 41 41 41 41 41 41 41 41 26 41 41 41 41 41 41 41 41 41 41 41 41 41 
41 41 41 41 41 41 41 41 0 41 41 41 0 41 41 41 41 41 41 41 41 0 0 26 0 0 41 41 41 41 41 41 41 41 41 41 26 41 41 41 41 41 41 41 41 41 41 41 41 41 
41 41 41 41 41 41 41 41 0 41 41 41 0 41 41 41 41 41 41 41 41 41 0 26 0 41 41 41 41 41 41 41 41 41 41 41 26 41 41 41 41 41 41 41 41 41 41 41 41 41 
41 41 41 41 41 41 41 41 0 41 41 41 0 0 0 41 41 41 41 41 41 41 41 26 41 41 41 41 41 41 41 41 41 41 41 41 26 41 41 41 41 41 41 41 41 41 41 41 41 41 
41 41 41 41 41 41 41 41 0 41 41 41 41 41 0 41 41 41 41 41 41 41 41 26 41 41 41 41 41 41 41 41 41 41 41 41 26 41 41 41 41 41 41 41 41 41 41 41 41 41 
41 41 41 41 41 41 41 41 0 41 41 41 41 41 0 41 41 41 41 41 41 41 41 26 41 41 41 0 41 41 41 41 41 41 41 0 26 41 41 41 41 41 41 41 41 41 41 41 41 41 
41 41 41 41 41 41 41 41 0 41 41 41 41 41 0 41 41 41 41 41 41 41 41 26 41 41 41 41 41 41 0 41 41 41 41 41 26 41 41 41 41 41 41 41 41 41 41 41 41 41 
41 41 41 41 41 41 41 41 0 0 0 0 0 0 0 41 41 41 41 41 41 41 41 26 41 41 41 41 41 41 0 41 41 41 41 41 26 41 41 41 41 41 41 41 41 41 41 41 41 41 
41 41 41 41 41 41 41 41 0 0 0 0 0 0 0 41 41 41 41 41 41 41 41 26 41 41 41 41 41 41 41 41 41 41 41 41 0 41 41 41 41 41 41 41 41 41 41 41 41 41 
41 41 41 41 41 41 41 41 0 0 0 0 0 0 0 41 41 41 41 41 41 41 41 26 41 41 41 41 41 41 41 41 41 41 41 0 0 0 41 41 41 41 41 41 41 41 41 41 41 41 
41 41 41 41 41 41 41 41 0 0 0 0 0 0 0 41 41 41 41 41 41 41 41 26 41 41 41 41 41 41 41 41 41 41 41 0 0 0 41 41 41 41 41 41 41 41 41 41 41 41 
41 41 41 41 41 41 41 41 0 0 0 0 0 0 0 41 41 41 41 41 41 41 41 26 41 41 41 41 41 41 41 41 41 41 41 0 0 0 41 41 41 41 41 41 41 41 41 41 41 41 
41 41 41 41 41 41 41 41 0 0 0 0 0 0 0 41 41 41 41 41 41 41 41 26 41 41 41 41 41 41 41 41 41 41 41 0 0 0 41 41 41 41 41 41 41 41 41 41 41 41 
41 41 41 41 41 41 41 41 41 41 41 41 41 41 41 41 41 41 41 41 41 41 41 26 41 41 41 41 41 41 41 41 41 41 41 0 0 0 41 41 41 41 41 41 41 41 41 41 41 41 
41 41 41 41 41 41 41 41 41 41 41 41 41 41 41 41 41 41 41 0 0 0 0 0 0 0 0 41 41 41 41 41 41 41 0 0 0 0 0 41 41 41 41 41 41 41 41 41 41 41 
41 41 41 41 41 41 41 41 41 41 41 41 41 41 41 41 41 41 0 0 0 0 0 0 0 0 0 0 41 41 0 41 41 0 0 0 0 0 0 41 41 41 41 41 41 41 41 41 41 41 
41 41 41 41 41 41 41 41 41 41 41 41 41 41 41 41 41 41 0 0 0 0 0 0 0 0 0 0 41 41 41 41 0 0 0 0 0 0 0 41 41 41 41 41 41 41 41 41 41 41 
41 41 41 41 41 41 41 41 41 41 41 41 41 0 41 41 41 41 0 0 0 0 0 0 0 0 0 0 0 41 41 41 0 0 0 0 0 41 0 41 41 41 41 41 41 41 41 41 41 41 
41 41 41 41 41 41 41 41 41 41 41 41 41 41 41 41 41 41 0 0 0 0 0 0 0 0 0 0 0 0 0 0 0 0 41 0 0 0 0 41 41 41 41 41 41 41 41 41 41 41 
41 41 41 41 41 41 41 41 41 41 41 41 41 0 41 41 41 41 41 0 0 0 0 0 0 0 0 41 41 41 41 0 0 0 0 0 0 0 0 41 41 41 41 41 41 41 41 41 41 41 
41 41 41 41 41 41 41 41 41 41 41 41 41 41 41 41 41 41 41 41 0 0 0 0 0 0 41 41 41 41 41 0 0 41 0 0 41 0 0 41 41 41 41 41 41 41 41 41 41 41 
41 41 41 41 41 41 41 41 41 41 41 41 41 41 41 41 41 41 41 41 41 41 41 41 41 41 41 41 41 41 41 41 0 0 0 0 0 0 41 41 41 41 41 41 41 41 41 41 41 41 
41 41 41 41 41 41 41 41 41 41 41 41 41 41 41 41 41 41 41 41 41 41 41 41 41 41 41 41 41 41 41 41 41 41 41 41 41 41 41 41 41 41 41 41 41 41 41 41 41 41 
41 41 41 41 41 41 41 41 41 41 41 41 41 41 41 41 41 41 41 41 41 41 41 41 41 41 41 41 41 41 41 41 41 41 41 41 41 41 41 41 41 41 41 41 41 41 41 41 41 41 
41 41 41 41 41 41 41 41 41 41 41 41 41 41 41 41 41 41 41 41 41 41 41 41 41 41 41 41 41 41 41 41 41 41 41 41 41 41 41 41 41 41 41 41 41 41 41 41 41 41 
41 41 41 41 41 41 41 41 41 41 41 41 41 41 41 41 41 41 41 41 41 41 41 41 41 41 41 41 41 41 41 41 41 41 41 41 41 41 41 41 41 41 41 41 41 41 41 41 41 41 
41 41 41 41 41 41 41 41 41 41 41 41 41 41 41 41 41 41 41 41 41 41 41 41 41 41 41 41 41 41 41 41 41 41 41 41 41 41 41 41 41 41 41 41 41 41 41 41 41 41 
41 41 41 41 41 41 41 41 41 41 41 41 41 41 41 41 41 41 41 41 41 41 41 41 41 41 41 41 41 41 41 41 41 41 41 41 41 41 41 41 41 41 41 41 41 41 41 41 41 41 