39 39 39 39 39 39 39 39 39 39 39 39 39 39 39 39 39 39 39 39 39 39 39 39 39 39 39 39 39 39 39 39 39 39 39 39 39 39 39 39 39 39 39 39 39 39 39 39 39 39
39 39 39 39 39 39 39 39 39 39 39 39 39 39 39 39 39 39 39 39 39 39 39 39 39 39 39 39 39 39 39 39 39 39 39 39 39 39 39 39 39 39 39 39 39 39 39 39 39 39
39 39 39 39 39 39 39 39 39 39 39 39 39 39 39 39 39 39 39 39 39 39 39 39 39 39 39 39 39 39 39 39 39 39 39 39 39 39 39 39 39 39 39 39 39 39 39 39 39 39
39 39 39 39 39 39 39 39 39 39 39 39 39 39 39 39 39 39 39 39 39 39 39 39 39 39 39 39 39 39 39 39 39 39 39 39 39 39 39 39 39 39 39 39 39 39 39 39 39 39
39 39 39 39 39 39 39 39 39 39 39 39 39 39 39 39 39 39 39 39 39 39 39 39 39 39 39 39 39 39 39 39 39 39 39 39 39 39 39 39 39 39 39 39 39 39 39 39 39 39
39 39 39 39 39 39 39 39 39 39 39 39 39 39 39 39 39 39 39 39 39 39 39 39 39 39 39 39 39 39 39 39 39 39 39 39 39 39 39 39 39 39 39 39 39 39 39 39 39 39
39 39 39 39 39 39 39 39 39 43 36 36 36 36 36 36 44 39 39 43 36 36 36 36 36 36 36 44 39 39 39 39 43 36 36 36 36 36 36 36 36 36 44 39 39 39 39 39 39 39
39 39 39 39 39 39 39 39 43 35 02 02 02 80 81 02 37 36 36 35 02 80 81 64 65 66 67 37 36 36 36 36 35 02 64 65 66 67 80 81 02 02 40 39 39 39 39 39 39 39 
39 39 39 39 39 39 39 39 38 64 65 66 67 82 83 80 81 00 02 80 81 82 83 68 69 70 71 00 01 80 81 80 81 02 68 69 70 71 82 83 02 02 40 39 39 39 39 39 39 39
39 39 39 39 39 39 39 39 38 68 69 70 71 00 01 82 83 80 81 82 83 00 02 72 73 74 75 01 02 82 83 82 83 02 72 73 74 75 02 02 02 02 40 39 39 39 39 39 39 39 
39 39 39 39 39 39 39 39 38 72 73 74 75 80 81 80 81 82 83 02 02 02 01 76 77 78 79 80 81 64 65 66 67 02 76 77 78 79 02 02 02 02 40 39 39 39 39 39 39 39 
39 39 39 39 39 39 39 39 38 76 77 78 79 82 83 82 83 93 94 95 96 97 98 02 02 02 02 82 83 68 69 70 71 02 02 02 02 02 02 02 80 81 40 39 39 39 39 39 39 39 
39 39 39 39 39 39 39 39 38 00 80 81 80 81 80 81 02 99 100 101 102 103 104 34 42 42 42 42 41 72 73 74 75 02 02 02 02 02 02 02 82 83 40 39 39 39 39 39 39 39 
39 39 39 39 39 39 39 39 38 02 82 83 82 83 82 83 01 105 106 107 108 109 110 40 39 39 39 39 38 76 77 78 79 02 02 02 02 02 80 81 34 42 46 39 39 39 39 39 39 39 
39 39 39 39 39 39 39 39 45 41 64 65 66 67 02 02 02 111 112 113 114 115 116 40 39 39 39 39 38 80 81 02 02 02 02 02 80 81 82 83 40 39 39 39 39 39 39 39 39 39 
39 39 39 39 39 39 39 39 39 38 68 69 70 71 02 02 02 117 118 119 120 121 122 40 39 39 39 39 38 82 83 02 02 02 02 02 82 83 02 02 40 39 39 39 39 39 39 39 39 39 
39 39 39 39 39 39 39 39 39 38 72 73 74 75 02 02 02 02 02 02 02 02 02 40 39 39 39 39 38 02 02 02 02 02 64 65 66 67 02 02 40 39 39 39 39 39 39 39 39 39 
39 39 39 39 39 39 39 43 36 35 76 77 78 79 02 02 02 02 02 02 02 02 02 37 36 36 36 36 35 02 02 02 02 02 68 69 70 71 02 02 40 39 39 39 39 39 39 39 39 39 
39 39 39 39 39 39 39 38 02 02 02 02 07 08 08 08 09 02 02 02 02 02 02 02 02 02 02 02 02 02 02 02 02 02 72 73 74 75 03 04 40 39 39 39 39 39 39 39 39 39 
39 39 39 39 39 39 39 38 25 26 27 02 10 12 12 12 11 02 02 02 02 02 02 02 02 02 02 02 02 02 02 02 80 81 76 77 78 79 05 06 40 39 39 39 39 39 39 39 39 39 
39 39 39 39 39 39 39 38 28 29 30 02 10 12 12 12 11 02 25 26 27 64 65 66 67 02 02 02 02 02 02 02 82 83 80 81 80 81 02 00 40 39 39 39 39 39 39 39 39 39 
39 39 39 39 39 39 39 38 31 32 33 01 13 14 14 14 15 02 28 00 30 68 69 70 71 02 02 02 02 02 02 02 02 02 82 83 82 83 02 34 46 39 39 39 39 39 39 39 39 39 
39 39 39 39 39 39 39 38 02 64 65 66 67 02 02 02 02 02 31 32 33 72 73 74 75 02 02 02 02 02 02 02 01 64 65 66 67 02 01 40 39 39 39 39 39 39 39 39 39 39 
39 39 39 39 39 39 39 45 41 68 69 70 71 02 02 02 02 02 02 02 02 76 77 78 79 02 02 02 02 02 02 80 81 68 69 70 71 80 81 40 39 39 39 39 39 39 39 39 39 39 
39 39 39 39 39 39 39 39 38 72 73 74 75 02 02 00 02 02 02 64 65 66 67 02 02 02 00 02 02 02 02 82 83 72 73 74 75 82 83 40 39 39 39 39 39 39 39 39 39 39 
39 39 39 39 39 39 39 39 38 76 77 78 79 02 02 02 00 02 02 68 69 70 71 02 80 81 02 02 02 64 65 66 67 76 77 78 79 80 81 40 39 39 39 39 39 39 39 39 39 39 
39 39 39 39 39 39 39 43 35 02 02 02 80 81 02 02 02 02 02 72 73 74 75 02 82 83 02 02 02 68 69 70 71 80 81 80 81 82 83 40 39 39 39 39 39 39 39 39 39 39 
39 39 39 39 39 39 39 38 64 65 66 67 82 83 02 02 02 02 02 76 77 78 79 80 81 02 02 02 02 72 73 74 75 82 83 82 83 02 02 40 39 39 39 39 39 39 39 39 39 39 
39 39 39 39 39 39 39 38 68 69 70 71 02 02 02 02 02 02 80 81 02 02 01 82 83 02 02 02 02 76 77 78 79 02 64 65 66 67 02 40 39 39 39 39 39 39 39 39 39 39 
39 39 39 39 39 39 39 38 72 73 74 75 80 81 02 02 02 02 82 83 64 65 66 67 02 02 02 02 02 02 02 80 81 02 68 69 70 71 00 40 39 39 39 39 39 39 39 39 39 39 
39 39 39 39 39 39 39 38 76 77 78 79 82 83 02 02 00 02 02 02 68 69 70 71 02 02 02 02 02 02 02 82 83 01 72 73 74 75 34 46 39 39 39 39 39 39 39 39 39 39 
39 39 39 39 39 39 39 45 41 80 81 02 64 65 66 67 02 02 02 02 72 73 74 75 02 02 01 02 02 02 02 02 02 00 76 77 78 79 40 39 39 39 39 39 39 39 39 39 39 39 
39 39 39 39 39 39 39 39 38 82 83 02 68 69 70 71 02 02 02 02 76 77 78 79 02 02 02 02 84 91 91 91 91 91 91 91 91 85 40 39 39 39 39 39 39 39 39 39 39 39 
39 39 39 39 39 39 39 39 38 02 02 01 72 73 74 75 02 02 02 02 02 02 02 02 02 02 02 02 02 02 02 01 02 80 81 80 81 87 40 39 39 39 39 39 39 39 39 39 39 39 
39 39 39 39 39 39 39 39 38 02 80 81 76 77 78 79 02 02 02 02 02 02 02 02 02 02 02 02 02 02 02 02 02 82 83 82 83 87 40 39 39 39 39 39 39 39 39 39 39 39 
39 39 39 39 39 39 39 39 38 00 82 83 07 08 08 08 09 02 02 02 02 02 02 02 02 02 02 02 86 02 47 48 49 50 02 02 01 87 37 44 39 39 39 39 39 39 39 39 39 39 
39 39 39 39 39 39 39 43 35 80 81 02 10 12 12 12 11 02 02 02 02 02 02 02 02 02 02 02 86 02 51 52 53 54 02 01 02 87 00 37 44 39 39 39 39 39 39 39 39 39 
39 39 39 39 39 39 39 38 02 82 83 00 10 12 12 12 11 00 02 02 80 81 80 81 80 81 02 02 86 02 55 56 57 58 01 02 01 87 03 04 40 39 39 39 39 39 39 39 39 39 
39 39 39 39 39 39 39 38 64 65 66 67 10 12 12 12 11 01 80 81 82 83 82 83 82 83 80 81 86 02 59 60 61 62 02 80 81 87 05 06 40 39 39 39 39 39 39 39 39 39 
39 39 39 39 39 39 39 38 68 69 70 71 13 14 14 14 15 02 82 83 00 25 26 26 26 27 82 83 86 01 00 02 02 01 02 82 83 87 02 02 40 39 39 39 39 39 39 39 39 39 
39 39 39 39 39 39 39 38 72 73 74 75 02 80 81 02 02 02 00 80 81 28 02 02 01 30 02 02 88 91 91 91 91 91 91 91 91 89 02 00 40 39 39 39 39 39 39 39 39 39 
39 39 39 39 39 39 39 38 76 77 78 79 01 82 83 34 42 42 41 82 83 28 00 02 02 30 00 34 42 42 41 02 80 81 80 81 80 81 80 81 40 39 39 39 39 39 39 39 39 39 
39 39 39 39 39 39 39 38 00 02 01 02 02 00 34 46 39 39 45 41 02 31 32 32 32 33 34 46 39 39 38 02 82 83 82 83 82 83 82 83 40 39 39 39 39 39 39 39 39 39 
39 39 39 39 39 39 39 45 42 42 42 42 42 42 46 39 39 39 39 45 42 42 42 42 42 42 46 39 39 39 45 41 02 02 02 02 02 02 34 42 46 39 39 39 39 39 39 39 39 39 
39 39 39 39 39 39 39 39 39 39 39 39 39 39 39 39 39 39 39 39 39 39 39 39 39 39 39 39 39 39 39 45 42 42 42 42 42 42 46 39 39 39 39 39 39 39 39 39 39 39 
39 39 39 39 39 39 39 39 39 39 39 39 39 39 39 39 39 39 39 39 39 39 39 39 39 39 39 39 39 39 39 39 39 39 39 39 39 39 39 39 39 39 39 39 39 39 39 39 39 39 
39 39 39 39 39 39 39 39 39 39 39 39 39 39 39 39 39 39 39 39 39 39 39 39 39 39 39 39 39 39 39 39 39 39 39 39 39 39 39 39 39 39 39 39 39 39 39 39 39 39 
39 39 39 39 39 39 39 39 39 39 39 39 39 39 39 39 39 39 39 39 39 39 39 39 39 39 39 39 39 39 39 39 39 39 39 39 39 39 39 39 39 39 39 39 39 39 39 39 39 39 
39 39 39 39 39 39 39 39 39 39 39 39 39 39 39 39 39 39 39 39 39 39 39 39 39 39 39 39 39 39 39 39 39 39 39 39 39 39 39 39 39 39 39 39 39 39 39 39 39 39 
39 39 39 39 39 39 39 39 39 39 39 39 39 39 39 39 39 39 39 39 39 39 39 39 39 39 39 39 39 39 39 39 39 39 39 39 39 39 39 39 39 39 39 39 39 39 39 39 39 39 